init:
deps-jar:
Compiling 2 source files to D:\NetBeansProjects\Mapping\build\classes
compile:
run:
AbstractConcepts:   Abstract Concepts
ComputerValidationReport:   Computer Validation Report
QAInspector:   Q A Inspector
Charging:   Charging
ProductionTechnician:   Production Technician
Storage:   Storage
EquipmentCleaningTask:   Equipment Cleaning Task
ProcessValidationReport:   Process Validation Report
StartingMaterialTestTask:   Starting Material Test Task
OperationTime:   Operation Time
Extraction:   Extraction
Controller:   Controller
Substance:   Substance
Heating:   Heating
Blender:   Blender
StoichReaction:   Stoich Reaction
PharmaValidationStatus:   Pharma Validation Status
MaintenanceOperator:   Maintenance Operator
BatchNumber:   Batch Number
SupplierAssessmentReport:   Supplier Assessment Report
LabEngineer:   Lab Engineer
TimeCentrifuging:   Time Centrifuging
InstallationQualification:   Installation Qualification
Milling:   Milling
TimeCrystallization:   Time Crystallization
StorageEquipment:   Storage Equipment
Regulation:   Regulation
ActivePharmaceuticalIngredient:   Active Pharmaceutical Ingredient
Chromotograph:   Chromotograph
EquipmentCleanlinessTest:   Equipment Cleanliness Test
PostProcessTaskTime:   Post Process Task Time
TankProcedureTime:   Tank Procedure Time
Dispensing:   Dispensing
Classifying:   Classifying
MaterialLabel:   Material Label
IntraProcessTaskTime:   Intra Process Task Time
ExtractionColumn:   Extraction Column
PurchasingDepartment:   Purchasing Department
SingleValue:   Single Value
InvestigationReport:   Investigation Report
Pipe:   Pipe
MaintenanceDepartment:   Maintenance Department
Delaying:   Delaying
PhysicalConcepts:   Physical Concepts
TaskProcedure:   Task Procedure
UnitProcedure:   Unit Procedure
ProductionDepartment:   Production Department
ProductionCoordinator:   Production Coordinator
Assessing:   Assessing
ApprovedSupplier:   Approved Supplier
Crystallizer:   Crystallizer
Dryer:   Dryer
Purging:   Purging
TimeStoichReaction:   Time Stoich Reaction
DisapprovedSupplier:   Disapproved Supplier
MaterialStatus:   Material Status
MaterialPurchaseReport:   Material Purchase Report
AnalyticalEquipment:   Analytical Equipment
CleaningValidationReport:   Cleaning Validation Report
ProcessValidationPlan:   Process Validation Plan
Valve:   Valve
QualityControlDepartment:   Quality Control Department
PreProcessTask:   Pre Process Task
PerformanceQualification:   Performance Qualification
TimeDrying:   Time Drying
Sensor:   Sensor
Pump:   Pump
ApprovalStatus:   Approval Status
EquipmentSpecification:   Equipment Specification
DesignQualification:   Design Qualification
MaterialEvaluationTest:   Material Evaluation Test
Parameter:   Parameter
FilterProcedureTime:   Filter Procedure Time
PhysicalComponent:   Physical Component
ValidationRepresentative:   Validation Representative
PharmaSupplierAssessTask:   Pharma Supplier Assess Task
AssistantPurchasingOfficer:   Assistant Purchasing Officer
FlowEquipment:   Flow Equipment
QCCoordinator:   Q C Coordinator
ValidationReport:   Validation Report
NumericalValue:   Numerical Value
Crystallization:   Crystallization
PurchasingClericalAssistant:   Purchasing Clerical Assistant
DimensionSpecification:   Dimension Specification
Quantity:   Quantity
RegulatoryDomain:   Regulatory Domain
StatusOfTheContents:   Status Of The Contents
Cooling:   Cooling
TimeFiltering:   Time Filtering
Time:   Time
Evaluating:   Evaluating
TimeWashing:   Time Washing
ReactionYieldTest:   Reaction Yield Test
YieldDeviationReport:   Yield Deviation Report
PharmaSupplier:   Pharma Supplier
EquipmentModule:   Equipment Module
IntermediateMaterial:   Intermediate Material
Filter:   Filter
StartingMaterialPurchaseTask:   Starting Material Purchase Task
LabTechnician:   Lab Technician
Drying:   Drying
Filtering:   Filtering
PharmaCustomer:   Pharma Customer
MaterialEvaluationReport:   Material Evaluation Report
Equipment:   Equipment
Process:   Process
QAAuditor:   Q A Auditor
InvestigationTask:   Investigation Task
ValidationManager:   Validation Manager
PurchasingOfficer:   Purchasing Officer
ValidationTask:   Validation Task
AdministrationsDepartment:   Administrations Department
StorageTank:   Storage Tank
ProcessDomain:   Process Domain
IntraProcessTask:   Intra Process Task
PreProcessTaskTime:   Pre Process Task Time
UnitProcedureTime:   Unit Procedure Time
Cleaning:   Cleaning
Spectroscopy:   Spectroscopy
TimeDelaying:   Time Delaying
PostProcessTask:   Post Process Task
Port:   Port
Attribute:   Attribute
ThermalEquipment:   Thermal Equipment
ReactionYieldTestTask:   Reaction Yield Test Task
Purchasing:   Purchasing
Name:   Name
Washing:   Washing
Distillation:   Distillation
EquipmentSettings:   Equipment Settings
CleaningTaskTime:   Cleaning Task Time
StandardOperatingProcedure:   Standard Operating Procedure
QualityAssuranceDepartment:   Quality Assurance Department
EquipmentCleanlinessReport:   Equipment Cleanliness Report
DistillationColumn:   Distillation Column
TaskTime:   Task Time
Testing:   Testing
DocumentationStatus:   Documentation Status
Personnel:   Personnel
Document:   Document
Mill:   Mill
Investigating:   Investigating
CleanlinessTestTaskTime:   Cleanliness Test Task Time
Reactor:   Reactor
RangeValue:   Range Value
YieldTestTaskTime:   Yield Test Task Time
MaterialOfConstruction:   Material Of Construction
DryerProcedureTime:   Dryer Procedure Time
Writing:   Writing
Centrifuging:   Centrifuging
ActuatingEquipment:   Actuating Equipment
MaterialofConstructionSpecification:   Materialof Construction Specification
InvestigatoryEntity:   Investigatory Entity
QualityControlLaboratory:   Quality Control Laboratory
ProcessingEquipment:   Processing Equipment
ValidationTest:   Validation Test
Action:   Action
ComputerValidationPlan:   Computer Validation Plan
Sinking:   Sinking
QACoordinator:   Q A Coordinator
TimeStorage:   Time Storage
WrittenProcedure:   Written Procedure
Qualification:   Qualification
Stream:   Stream
ReactorProcedureTime:   Reactor Procedure Time
OperationalQualification:   Operational Qualification
ThirdParty:   Third Party
Centrifuge:   Centrifuge
Operation:   Operation
CleaningValidationPlan:   Cleaning Validation Plan
TaskReport:   Task Report
EquipmentCleanlinessTestTask:   Equipment Cleanliness Test Task
CentrifugeProcedureTime:   Centrifuge Procedure Time
QCOfficer:   Q C Officer
ValidationPlan:   Validation Plan
ProductionEngineer:   Production Engineer
StartingMaterial:   Starting Material
UnknownSupplier:   Unknown Supplier
Position:   Position
CrystallizerProcedureTime:   Crystallizer Procedure Time
State:   State
BUILD SUCCESSFUL (total time: 2 seconds)
